WWWWWWWWWWWWWWWWWWWWWWWWWWWWWWWWWWWWWWWWWWWWWWWWWWWWWWWWWWWWWWWWWWWWWWWWWWWWWWWW
W                                                                              W
W                                                                              W
W                                                                              W
W                                                                              W
W                                                                              W
WWWWWWWWWW    WWWWWWWWWW    WWWWWWWWWW    WWWWWWWWWW    WWWWWWWWWW    WWWWWWWWWW
W                                                                              W
W                                                                              W
W                                                                              W
W     WWWWWWWWWWWW                WWWWWWWWWWWW                WWWWWWWWWWWW     W
W     W          W                W          W                W          W     W
W     W          W                W          W                W          W     W
W     W          W                W          W                W          W     W
W     WWWWWWWWWWWW                WWWWWWWWWWWW                WWWWWWWWWWWW     W
W                                                                              W
W                                                                              W
W                                                                              W
W                                                                              W
W     WWWWWWWWWWWW                WWWWWWWWWWWW                WWWWWWWWWWWW     W
W     W          W                W          W                W          W     W
W     W          W                W          W                W          W     W
W     W          W                W          W                W          W     W
W     WWWWWWWWWWWW                WWWWWWWWWWWW                WWWWWWWWWWWW     W
W                                                                              W
W                                                                              W
W                                                                              W
WWWWWWWWWW    WWWWWWWWWW    WWWWWWWWWW    WWWWWWWWWW    WWWWWWWWWW    WWWWWWWWWW
W                                                                              W
W                                                                              W
W                                                                              W
W                                                                              W
W                                                                              W
WWWWWWWWWWWWWWWWWWWWWWWWWWWWWWWWWWWWWWWWWWWWWWWWWWWWWWWWWWWWWWWWWWWWWWWWWWWWWWWW